20 20
20 300
0 0 0 0 0 0 0 0 0 0 0 0 0 0 0 0 0 0 0 0
0 0 0 0 0 0 0 0 0 0 0 0 0 0 0 0 0 0 0 0
0 0 0 0 0 0 0 0 0 0 0 0 0 0 0 0 0 0 0 0
0 0 0 0 0 0 0 0 0 0 0 0 0 0 0 0 0 0 0 0
0 0 0 0 0 0 0 0 0 0 0 0 0 0 0 0 0 0 0 0
0 0 0 0 0 0 0 0 0 0 0 0 0 0 0 0 0 0 0 0
0 0 0 0 0 0 0 0 0 0 0 0 0 0 0 0 0 0 0 0
0 0 0 0 0 0 0 0 0 0 0 0 0 0 0 0 0 0 0 0
0 0 0 0 0 0 0 0 0 0 0 0 0 0 0 0 0 0 0 0
0 0 0 0 0 0 0 0 0 0 0 0 0 0 0 0 0 0 0 0
0 0 0 0 0 0 0 0 0 0 0 0 1 0 0 1 0 0 0 0
0 0 0 2 0 0 2 0 0 0 0 0 0 0 0 0 0 0 0 0
0 0 0 0 0 0 0 0 0 0 0 0 0 0 0 0 0 0 0 0
0 0 0 0 0 0 0 0 0 0 0 0 0 0 0 0 0 0 0 0
0 0 0 0 0 0 0 0 0 0 0 0 0 0 0 0 0 0 0 0
0 0 0 0 0 0 0 0 0 0 0 0 0 0 0 0 0 0 0 0
0 0 0 0 0 0 0 0 0 0 0 0 0 0 0 0 0 0 0 0
0 0 0 0 0 0 0 0 0 0 0 0 0 0 0 0 0 0 0 0
0 0 0 0 0 0 0 0 0 0 0 0 0 0 0 0 0 0 0 0
0 0 0 0 0 0 0 0 0 0 0 0 0 0 0 0 0 0 0 0

G G G G G G G G G G G G G G G G G G G G
G P P P P P P P P P P P P P P P P P P G
G G G G G G G G G G G G G G G G G G P G
G P P P P P P P P P P P P P P P P G P G
G P G G G G G G G G G G G G G G P G P G
G P G P P P P P P P P P P P P P P G P G
G P G G G G G G G G G G G G G G G G P G
G P P P P P P P P P P P P P P P P P P G
G T G G G G G G G T G G P G G P G G T G
G T G P P P P G G T G G P G G P G G T G
G T G P G G P G G T G G P P P P G G T G
G T G P G G P G G T G G G G G G G G T G
G P P P P P P P P P P P P P P P P P P G
G P G G G G G G G P G G G G G G G G P G
G P P P P P P P G P G P P P P P P G P G
G P G G G G G P G P G P G G G G G G P G
G P G P P P P P G P G P P P P P P P P G
G P G G G G G G G P G G G G G G G G P G
G P P P P P P P P P P P P P P P P P P G
G G G G G G G G G G G G G G G G G G G G