20 20
40 300
0 0 0 0 0 0 0 0 0 0 0 0 0 0 0 0 0 0 0 0
0 0 0 0 0 0 0 0 0 0 0 0 0 0 0 0 0 0 0 0
0 0 0 0 0 0 0 0 0 0 0 0 0 0 0 0 0 0 1 0
0 2 0 0 0 0 0 0 0 0 0 0 0 0 0 0 0 0 0 0
0 0 0 0 0 0 0 0 0 0 0 0 0 0 0 0 0 0 0 0
0 0 0 0 0 0 0 0 0 0 0 0 0 0 0 0 0 0 0 0
0 0 0 0 0 0 0 0 0 0 0 0 0 0 0 0 0 0 0 0
0 0 0 0 0 0 0 0 0 0 0 0 0 0 0 0 0 0 0 0
0 0 0 0 0 0 0 0 0 0 0 0 0 0 0 0 0 0 0 0
0 0 0 0 0 0 0 0 0 0 0 0 0 0 0 0 0 0 0 0
0 0 0 0 0 0 0 0 0 0 0 0 0 0 0 0 0 0 0 0
0 0 0 0 0 0 0 0 0 0 0 0 0 0 0 0 0 0 0 0
0 0 0 0 0 0 0 0 0 0 0 0 0 0 0 0 0 0 0 0
0 0 0 0 0 0 0 0 0 0 0 0 0 0 0 0 0 0 0 0
0 0 0 0 0 0 0 0 0 0 0 0 0 0 0 0 0 0 0 0
0 0 0 0 0 0 0 0 0 0 0 0 0 0 0 0 0 0 0 0
0 0 0 0 0 0 0 0 0 0 0 0 0 0 0 0 0 0 0 0
0 0 0 0 0 0 0 0 0 0 0 0 0 0 0 0 0 0 0 0
0 0 0 0 0 0 0 2 0 0 0 0 0 0 0 0 0 1 0 0
0 0 0 0 0 0 0 0 0 0 0 0 0 0 0 0 0 0 0 0

G G G G G G G G G G G G G G G G G G G G
G G P G G G P G G P G G P P P P P G P G
G P P P P G P G G P P G P G G G T P P G
G P G G P P P P G G P P P G G G T G G G
G P P G G G G P G G T G P G G G T P P G
G G P G G G P T T T T G P G G G T G G G
G G P P G G P G G T G G P P P P P G G G
G G G P G P P G G T G G G G G G P P P G
G P P P P P G G G T P P G G G G G G P G
G G G P G G G G G G G P P P P P P G P G
G G G P G G G G G G G T G P G G P G P G
G T T P P P P P G G G T G P G G P P P G
G T G G G P G P T T T T T P G G G G G G
G T G P P P G G G G T G G P G G G G G G
G T G P G G G G G G T G G P P P P G G G
G P P P P G G P P P P G G P G G P P G G
G G G G P G G P G G G G G P G G G P G G
G G G G P P P P G G G G G P G P G P G G
G G G G G G G P P P P P P P G P P P G G
G G G G G G G G G G G G G G G G G G G G